####################################################################
#          P                                                       #
#                                                                  #
#  XO   ### ######  ######### ########  ############################
#               #              #                                   #
# O        ######              #                                   #
#                              #                                   #
#    X                         #                                   #
#                              #                                   #
#                     ##############################################
#                      #
#########     ######   #
#########     ######  ##
#########     ######   #
#                      #
#                      #
#                      #
#                      #
#                      #
#                      #
#                      #
########################
