############
#          #
#          #
# PXO   ####
#          #
# OX       #
############