############
#          #
#          #
# P O   ####
#          #
# O     *  #
############
