############
#          #
#          #
#  XO   ####
#          #
# OX       #
############
