####################################################################
#          P                                                       #
#                                                                  #
#  XO   ### ######  ######### ########  ############################
#               #                                                  #
# O        ######                                                  #
#                                                                  #
#    X                                                             #
#                                                                  #
#                                                                  #
#                                                                  #
#                                                                  #
#                                                                  #
#                                                                  #
#                                                                  #
#                                                                  #
#                                                                  #
#                                                                  #
#                                                                  #
####################################################################
