############
#          #
#          #
# P O   ####
#          #
# O        #
############
