############
#          #
#          #
# PXO   ####
#          #
#          #
############
