############
#          #
#          #
# P O   ####
#          #
# OX       #
############
