############
#   PP     #
#          #
#  XO   ####
#          #
# OX       #
############
